11111111111111111111111111
1000100000L000000000000001
1100000000L000000000000001
100P100000L000000B00000001
11000000000000000000000001
10000000000000000000000001
10000000000000000000000001
10000000000000000000000001
10000000000000000000000001
10000000000000000000000001
10000000000000000000000001
10000000000000000000000001
1E0000000000000000000C0001
10000000000000000000000001
11111111111111111111111111