11111111111111111111111111
100010000CL0000C0000000001
1100000000L111110000000001
1E0P100000L000000B00000001
1100000000L000000000000001
11111111111111111111111111
11111111111111111111111111
11111111111111111111111111
11111111111111111111111111
11111111111111111111111111
11111111111111111111111111
11111111111111111111111111
11111111111111111111111111
11111111111111111111111111