111111111111111111111111111111111111111111
100000000010000000000000000000000000000001
100001110111000101011000000000000000000001
1C0000110010001111011000000000000000000001
1PE000000000001100000000000000000000000001
111000110110000010010000000000000000000001
111101111111000110011000000000000000000001
111111111111100000000B00000000000000000001
111111000000010000000000000000000000000001
111000000000001000000000000000000000000001
111111111111111111111111111111111111111111