111111111111111111111111111111111111111111111111111111111111111
100000000010000000000000000000000000000000000000000000000000001
100001110111000101011000000000000000000000000000000000000000001
1CL000110010001111011000000000000000000000000000000000000000001
1PE000000000001100000000000000000000000000000000000000000000001
111000110110000010010000000000000000000000000000000000000000001
111101111111000110011000000000000000000000000000000000000000001
111111111111100000000B00000000000000000000000C000000000L0000001
1111110000000100000000000000000000000000000001111111111L0000001
1110000000000010000000000000000000000000000000000000000L0000001
1111111111111111000000000000000000000000000000L00000000L00000C1
1111111111111111100000000000000000000000000000L1111111111111111
1111111111111111110000000000000000000000000000L0000000000000001
1111111111111111111000000000000000000000000000L0000000C00000001
1111111111111111111100000000000000000000000000L0000000000000001
111111111111111111111111111111111111111111111111111111111111111
111111111111111111111111111111111111111111111111111111111111111
111111111111111111111111111111111111111111111111111111111111111
111111111111111111111111111111111111111111111111111111111111111
111111111111111111111111111111111111111111111111111111111111111
111111111111111111111111111111111111111111111111111111111111111
111111111111111111111111111111111111111111111111111111111111111
111111111111111111111111111111111111111111111111111111111111111
111111111111111111111111111111111111111111111111111111111111111
111111111111111111111111111111111111111111111111111111111111111
111111111111111111111111111111111111111111111111111111111111111
111111111111111111111111111111111111111111111111111111111111111
111111111111111111111111111111111111111111111111111111111111111